2 13 31
###############################
#p   *2     s *  ** * *  4   *#
# # # # #*# # #*# # # # # #*# #
# x  f * *** **      *    **  #
# #*# # # # # # #b# # # # # #*#
#          *     **   s  *  **#
# # x*# # # # # #*#*#*#*# # # #
#   *  2 2   b   b *s* *  4   #
# # # # #*# # # # # # #*# #*# #
#   ***f         *  3         #
# # # # # # # # # #*# # # # #*#
#  ** *   *    2      1  1    #
###############################